{
  "levelInfo": "This is level 2",
  "playerName": "Chap",
  "gameTimer": 90,
  "inventory": [],
  "treasuresNeeded": 5,
  "chap_location": {
    "x": 7,
    "y": 6
  },
  "board": [
    ["*", "*", "*", "*", "*", "*", "*", "*", "*", "*", "*", "*", "*", "*", "*", "*", "*", "*", "*", "*", "*", "*", "*", "*", "*", "*", "*", "*", "*", "*"],
    ["*", "*", "*", "*", "*", "*", "*", "*", "*", "*", "*", "*", "*", "*", "*", "*", "*", "*", "*", "*", "*", "*", "*", "*", "*", "*", "*", "*", "*", "*"],
    ["*", "*", "*", "*", "*", "*", "*", "*", "*", "*", "*", "*", "*", "*", "*", "*", "*", "*", "*", "*", "*", "*", "*", "*", "*", "*", "*", "*", "*", "*"],
    ["*", "*", "*", "*", "*", "*", "*", "*", "*", "*", "*", "*", "*", "*", "*", "*", "*", "*", "*", "*", "*", "*", "*", "*", "*", "*", "*", "*", "*", "*"],
    ["*", "*", "*", "*", "*", "*", "*", "*", "*", "*", "*", "*", "*", "*", "*", "*", "*", "*", "*", "*", "*", "*", "*", "*", "*", "*", "*", "*", "*", "*"],
    ["*", "*", "*", "*", "*", "#", "#", "#", "#", "#", "#", "#", "#", "#", "#", "#", "#", "#", "#", "#", "#", "#", "#", "#", "#", "*", "*", "*", "*", "*"],
    ["*", "*", "*", "*", "*", "#", "-", "-", "-", "#", "-", "-", "-", "#", "-", "#", "-", "-", "-", "-", "#", "-", "B", "g", "#", "*", "*", "*", "*", "*"],
    ["*", "*", "*", "*", "*", "#", "p", "-", "-", "#", "-", "-", "-", "#", "-", "-", "-", "#", "#", "-", "#", "-", "#", "R", "#", "*", "*", "*", "*", "*"],
    ["*", "*", "*", "*", "*", "#", "-", "-", "-", "#", "-", "-", "-", "#", "-", "#", "-", "-", "#", "-", "#", "-", "#", "-", "#", "*", "*", "*", "*", "*"],
    ["*", "*", "*", "*", "*", "#", "#", "#", "-", "#", "-", "#", "#", "#", "-", "-", "#", "-", "#", "-", "#", "-", "#", "-", "#", "*", "*", "*", "*", "*"],
    ["*", "*", "*", "*", "*", "#", "b", "-", "-", "#", "-", "#", "-", "-", "-", "#", "-", "-", "#", "-", "-", "-", "#", "T", "#", "*", "*", "*", "*", "*"],
    ["*", "*", "*", "*", "*", "#", "-", "-", "-", "#", "-", "-", "-", "-", "#", "-", "-", "#", "#", "#", "#", "-", "#", "-", "#", "*", "*", "*", "*", "*"],
    ["*", "*", "*", "*", "*", "#", "-", "#", "#", "#", "-", "-", "-", "-", "#", "-", "#", "-", "-", "-", "#", "-", "#", "-", "#", "*", "*", "*", "*", "*"],
    ["*", "*", "*", "*", "*", "#", "-", "-", "-", "#", "-", "-", "-", "#", "-", "-", "#", "-", "#", "-", "#", "-", "#", "-", "#", "*", "*", "*", "*", "*"],
    ["*", "*", "*", "*", "*", "#", "#", "#", "-", "#", "-", "-", "#", "-", "-", "#", "-", "-", "#", "-", "G", "#", "#", "-", "#", "*", "*", "*", "*", "*"],
    ["*", "*", "*", "*", "*", "#", "-", "B", "-", "#", "-", "-", "#", "-", "#", "-", "-", "#", "#", "#", "-", "g", "#", "-", "#", "*", "*", "*", "*", "*"],
    ["*", "*", "*", "*", "*", "#", "-", "#", "-", "#", "-", "-", "#", "-", "-", "-", "#", "#", "y", "#", "-", "-", "#", "-", "#", "*", "*", "*", "*", "*"],
    ["*", "*", "*", "*", "*", "#", "-", "#", "-", "#", "-", "#", "#", "#", "#", "#", "#", "#", "-", "#", "-", "-", "#", "T", "#", "*", "*", "*", "*", "*"],
    ["*", "*", "*", "*", "*", "#", "-", "#", "-", "-", "-", "#", "-", "e", "-", "e", "-", "e", "-", "#", "-", "r", "#", "-", "#", "*", "*", "*", "*", "*"],
    ["*", "*", "*", "*", "*", "#", "-", "#", "#", "#", "#", "#", "-", "-", "-", "-", "-", "-", "-", "#", "#", "#", "#", "-", "#", "*", "*", "*", "*", "*"],
    ["*", "*", "*", "*", "*", "#", "-", "-", "-", "-", "-", "r", "-", "-", "-", "-", "-", "-", "-", "-", "-", "-", "-", "-", "#", "*", "*", "*", "*", "*"],
    ["*", "*", "*", "*", "*", "#", "#", "#", "#", "#", "#", "#", "e", "-", "e", "-", "e", "-", "e", "#", "#", "#", "#", "G", "#", "*", "*", "*", "*", "*"],
    ["*", "*", "*", "*", "*", "#", "-", "E", "-", "-", "T", "#", "#", "#", "#", "#", "Y", "#", "#", "#", "-", "-", "-", "-", "#", "*", "*", "*", "*", "*"],
    ["*", "*", "*", "*", "*", "#", "f", "#", "T", "-", "-", "-", "-", "-", "-", "-", "y", "-", "-", "-", "-", "T", "-", "-", "#", "*", "*", "*", "*", "*"],
    ["*", "*", "*", "*", "*", "#", "#", "#", "#", "#", "#", "#", "#", "#", "#", "#", "#", "#", "#", "#", "#", "#", "#", "#", "#", "*", "*", "*", "*", "*"],
    ["*", "*", "*", "*", "*", "*", "*", "*", "*", "*", "*", "*", "*", "*", "*", "*", "*", "*", "*", "*", "*", "*", "*", "*", "*", "*", "*", "*", "*", "*"],
    ["*", "*", "*", "*", "*", "*", "*", "*", "*", "*", "*", "*", "*", "*", "*", "*", "*", "*", "*", "*", "*", "*", "*", "*", "*", "*", "*", "*", "*", "*"],
    ["*", "*", "*", "*", "*", "*", "*", "*", "*", "*", "*", "*", "*", "*", "*", "*", "*", "*", "*", "*", "*", "*", "*", "*", "*", "*", "*", "*", "*", "*"],
    ["*", "*", "*", "*", "*", "*", "*", "*", "*", "*", "*", "*", "*", "*", "*", "*", "*", "*", "*", "*", "*", "*", "*", "*", "*", "*", "*", "*", "*", "*"],
    ["*", "*", "*", "*", "*", "*", "*", "*", "*", "*", "*", "*", "*", "*", "*", "*", "*", "*", "*", "*", "*", "*", "*", "*", "*", "*", "*", "*", "*", "*"]
  ]
}