{
  "levelInfo": "This is level 1",

  "playerName": "Chap",
  "gameTimer": 90,
  "treasuresNeeded": 4,
  "inventory": [],

  "chap_location": {
    "x": 7,
    "y": 7
  },
  "board": [
    ["*", "*", "*", "*", "*", "*", "*", "*", "*", "*", "*", "*", "*", "*", "*", "*", "*", "*", "*", "*", "*", "*", "*", "*", "*", "*", "*", "*", "*", "*"],
    ["*", "*", "*", "*", "*", "*", "*", "*", "*", "*", "*", "*", "*", "*", "*", "*", "*", "*", "*", "*", "*", "*", "*", "*", "*", "*", "*", "*", "*", "*"],
    ["*", "*", "*", "*", "*", "*", "*", "*", "*", "*", "*", "*", "*", "*", "*", "*", "*", "*", "*", "*", "*", "*", "*", "*", "*", "*", "*", "*", "*", "*"],
    ["*", "*", "*", "*", "*", "*", "*", "*", "*", "*", "*", "*", "*", "*", "*", "*", "*", "*", "*", "*", "*", "*", "*", "*", "*", "*", "*", "*", "*", "*"],
    ["*", "*", "*", "*", "*", "*", "*", "*", "*", "*", "*", "*", "*", "*", "*", "*", "*", "*", "*", "*", "*", "*", "*", "*", "*", "*", "*", "*", "*", "*"],
    ["*", "*", "*", "*", "*", "#", "#", "#", "#", "#", "#", "#", "#", "#", "#", "#", "#", "#", "#", "#", "#", "#", "#", "#", "#", "*", "*", "*", "*", "*"],
    ["*", "*", "*", "*", "*", "#", "-", "-", "-", "-", "-", "-", "-", "-", "#", "-", "-", "-", "-", "-", "-", "-", "-", "T", "#", "*", "*", "*", "*", "*"],
    ["*", "*", "*", "*", "*", "#", "-", "p", "-", "-", "-", "-", "-", "-", "G", "-", "-", "-", "-", "-", "-", "-", "-", "-", "#", "*", "*", "*", "*", "*"],
    ["*", "*", "*", "*", "*", "#", "-", "-", "-", "-", "-", "-", "-", "-", "#", "#", "#", "#", "#", "#", "#", "-", "-", "-", "#", "*", "*", "*", "*", "*"],
    ["*", "*", "*", "*", "*", "#", "-", "-", "-", "-", "-", "-", "-", "-", "#", "f", "-", "-", "-", "-", "#", "-", "-", "-", "#", "*", "*", "*", "*", "*"],
    ["*", "*", "*", "*", "*", "#", "-", "-", "-", "-", "-", "-", "-", "-", "#", "-", "-", "-", "-", "-", "#", "-", "-", "r", "#", "*", "*", "*", "*", "*"],
    ["*", "*", "*", "*", "*", "#", "-", "-", "-", "-", "-", "-", "-", "-", "#", "-", "-", "-", "-", "-", "#", "B", "#", "#", "#", "*", "*", "*", "*", "*"],
    ["*", "*", "*", "*", "*", "#", "-", "-", "-", "-", "-", "-", "-", "-", "#", "#", "#", "#", "E", "#", "#", "-", "#", "-", "#", "*", "*", "*", "*", "*"],
    ["*", "*", "*", "*", "*", "#", "-", "-", "-", "-", "-", "-", "-", "g", "#", "-", "-", "-", "-", "-", "#", "-", "#", "-", "#", "*", "*", "*", "*", "*"],
    ["*", "*", "*", "*", "*", "#", "R", "#", "#", "#", "#", "#", "#", "#", "#", "-", "-", "-", "-", "-", "#", "-", "#", "-", "#", "*", "*", "*", "*", "*"],
    ["*", "*", "*", "*", "*", "#", "-", "#", "-", "-", "-", "-", "-", "-", "-", "-", "-", "-", "-", "-", "#", "-", "#", "-", "#", "*", "*", "*", "*", "*"],
    ["*", "*", "*", "*", "*", "#", "-", "#", "-", "-", "-", "-", "-", "-", "-", "-", "-", "-", "-", "-", "#", "-", "#", "-", "#", "*", "*", "*", "*", "*"],
    ["*", "*", "*", "*", "*", "#", "-", "#", "-", "-", "-", "-", "-", "-", "-", "-", "-", "-", "#", "#", "#", "-", "#", "#", "#", "*", "*", "*", "*", "*"],
    ["*", "*", "*", "*", "*", "#", "-", "#", "-", "-", "-", "-", "-", "-", "-", "-", "-", "-", "#", "-", "-", "-", "-", "-", "#", "*", "*", "*", "*", "*"],
    ["*", "*", "*", "*", "*", "#", "-", "#", "#", "#", "#", "#", "Y", "#", "-", "-", "-", "-", "#", "-", "-", "-", "-", "-", "#", "*", "*", "*", "*", "*"],
    ["*", "*", "*", "*", "*", "#", "-", "-", "-", "-", "-", "-", "-", "#", "-", "-", "-", "-", "#", "-", "-", "-", "-", "-", "#", "*", "*", "*", "*", "*"],
    ["*", "*", "*", "*", "*", "#", "-", "-", "-", "-", "-", "-", "T", "#", "-", "-", "-", "-", "#", "-", "-", "-", "-", "-", "#", "*", "*", "*", "*", "*"],
    ["*", "*", "*", "*", "*", "#", "-", "-", "-", "-", "-", "-", "-", "#", "-", "-", "T", "-", "#", "y", "-", "-", "-", "-", "#", "*", "*", "*", "*", "*"],
    ["*", "*", "*", "*", "*", "#", "-", "-", "-", "-", "-", "-", "b", "#", "-", "-", "-", "-", "#", "-", "-", "-", "-", "T", "#", "*", "*", "*", "*", "*"],
    ["*", "*", "*", "*", "*", "#", "#", "#", "#", "#", "#", "#", "#", "#", "#", "#", "#", "#", "#", "#", "#", "#", "#", "#", "#", "*", "*", "*", "*", "*"],
    ["*", "*", "*", "*", "*", "*", "*", "*", "*", "*", "*", "*", "*", "*", "*", "*", "*", "*", "*", "*", "*", "*", "*", "*", "*", "*", "*", "*", "*", "*"],
    ["*", "*", "*", "*", "*", "*", "*", "*", "*", "*", "*", "*", "*", "*", "*", "*", "*", "*", "*", "*", "*", "*", "*", "*", "*", "*", "*", "*", "*", "*"],
    ["*", "*", "*", "*", "*", "*", "*", "*", "*", "*", "*", "*", "*", "*", "*", "*", "*", "*", "*", "*", "*", "*", "*", "*", "*", "*", "*", "*", "*", "*"],
    ["*", "*", "*", "*", "*", "*", "*", "*", "*", "*", "*", "*", "*", "*", "*", "*", "*", "*", "*", "*", "*", "*", "*", "*", "*", "*", "*", "*", "*", "*"],
    ["*", "*", "*", "*", "*", "*", "*", "*", "*", "*", "*", "*", "*", "*", "*", "*", "*", "*", "*", "*", "*", "*", "*", "*", "*", "*", "*", "*", "*", "*"]
  ]
}