{
  "levelInfo": "This is level 2",
  "playerName": "Chap",
  "gameTimer": 90,
  "inventory": [],
  "treasuresNeeded": 5,
  "chap_location": {
    "x": 6,
    "y": 8
  },
  "Enemy1_location": {
    "x": 21,
    "y": 12,
    "dir": 1
  },
  "Enemy2_location": {
    "x": 18,
    "y": 13,
    "dir": -1
  },
  "Enemy3_location": {
    "x": 18,
    "y": 15,
    "dir": -1
  },
  "Enemy4_location": {
    "x": 21,
    "y": 16,
    "dir": 1
  },
  "Enemy5_location": {
    "x": 21,
    "y": 18,
    "dir": 1
  },
  "board": [
    ["*", "*", "*", "*", "*", "*", "*", "*", "*", "*", "*", "*", "*", "*", "*", "*", "*", "*", "*", "*", "*", "*", "*", "*", "*", "*", "*", "*", "*", "*"],
    ["*", "*", "*", "*", "*", "*", "*", "*", "*", "*", "*", "*", "*", "*", "*", "*", "*", "*", "*", "*", "*", "*", "*", "*", "*", "*", "*", "*", "*", "*"],
    ["*", "*", "*", "*", "*", "*", "*", "*", "*", "*", "*", "*", "*", "*", "*", "*", "*", "*", "*", "*", "*", "*", "*", "*", "*", "*", "*", "*", "*", "*"],
    ["*", "*", "*", "*", "*", "*", "*", "*", "*", "*", "*", "*", "*", "*", "*", "*", "*", "*", "*", "*", "*", "*", "*", "*", "*", "*", "*", "*", "*", "*"],
    ["*", "*", "*", "*", "*", "*", "*", "*", "*", "*", "*", "*", "*", "*", "*", "*", "*", "*", "*", "*", "*", "*", "*", "*", "*", "*", "*", "*", "*", "*"],
    ["*", "*", "*", "*", "*", "#", "#", "#", "#", "#", "#", "#", "#", "#", "#", "#", "#", "#", "#", "#", "#", "#", "#", "#", "#", "*", "*", "*", "*", "*"],
    ["*", "*", "*", "*", "*", "#", "#", "-", "p", "#", "Q", "-", "-", "#", "-", "#", "-", "-", "-", "-", "#", "-", "B", "g", "#", "*", "*", "*", "*", "*"],
    ["*", "*", "*", "*", "*", "#", "-", "-", "#", "#", "#", "-", "#", "#", "-", "-", "-", "#", "#", "-", "#", "-", "#", "R", "#", "*", "*", "*", "*", "*"],
    ["*", "*", "*", "*", "*", "#", "-", "-", "-", "#", "-", "-", "-", "#", "-", "#", "-", "-", "#", "-", "#", "-", "#", "-", "#", "*", "*", "*", "*", "*"],
    ["*", "*", "*", "*", "*", "#", "#", "#", "-", "#", "-", "#", "#", "#", "-", "-", "#", "-", "#", "-", "#", "-", "#", "-", "#", "*", "*", "*", "*", "*"],
    ["*", "*", "*", "*", "*", "#", "b", "-", "-", "#", "-", "#", "-", "-", "-", "#", "-", "-", "#", "-", "-", "-", "#", "T", "#", "*", "*", "*", "*", "*"],
    ["*", "*", "*", "*", "*", "#", "-", "-", "-", "#", "-", "-", "-", "-", "#", "-", "-", "#", "#", "#", "#", "-", "#", "-", "#", "*", "*", "*", "*", "*"],
    ["*", "*", "*", "*", "*", "#", "-", "#", "#", "#", "#", "-", "-", "-", "#", "-", "#", "-", "-", "-", "#", "-", "#", "-", "#", "*", "*", "*", "*", "*"],
    ["*", "*", "*", "*", "*", "#", "-", "-", "-", "#", "-", "-", "-", "#", "-", "-", "#", "-", "#", "-", "#", "#", "-", "-", "#", "*", "*", "*", "*", "*"],
    ["*", "*", "*", "*", "*", "#", "#", "#", "-", "#", "-", "-", "#", "-", "-", "#", "-", "-", "#", "-", "G", "#", "-", "#", "#", "*", "*", "*", "*", "*"],
    ["*", "*", "*", "*", "*", "#", "-", "B", "-", "#", "-", "-", "#", "-", "#", "-", "-", "#", "-", "#", "-", "#", "-", "-", "#", "*", "*", "*", "*", "*"],
    ["*", "*", "*", "*", "*", "#", "-", "#", "-", "#", "-", "-", "#", "-", "-", "-", "#", "y", "-", "#", "g", "-", "#", "-", "#", "*", "*", "*", "*", "*"],
    ["*", "*", "*", "*", "*", "#", "-", "#", "-", "-", "-", "#", "#", "#", "#", "#", "#", "#", "-", "#", "-", "-", "#", "T", "#", "*", "*", "*", "*", "*"],
    ["*", "*", "*", "*", "*", "#", "-", "#", "#", "-", "-", "#", "-", "e", "-", "e", "-", "-", "-", "#", "-", "r", "#", "-", "#", "*", "*", "*", "*", "*"],
    ["*", "*", "*", "*", "*", "#", "-", "-", "-", "#", "#", "#", "-", "-", "-", "-", "-", "-", "-", "#", "#", "#", "#", "-", "#", "*", "*", "*", "*", "*"],
    ["*", "*", "*", "*", "*", "#", "-", "#", "-", "-", "-", "r", "-", "-", "-", "-", "-", "-", "-", "-", "-", "-", "-", "-", "#", "*", "*", "*", "*", "*"],
    ["*", "*", "*", "*", "*", "#", "#", "#", "#", "#", "#", "#", "e", "-", "-", "-", "e", "-", "e", "#", "#", "#", "#", "G", "#", "*", "*", "*", "*", "*"],
    ["*", "*", "*", "*", "*", "#", "-", "E", "-", "-", "T", "#", "#", "#", "#", "#", "Y", "#", "#", "#", "-", "-", "-", "-", "#", "*", "*", "*", "*", "*"],
    ["*", "*", "*", "*", "*", "#", "f", "#", "T", "#", "-", "-", "-", "-", "-", "-", "y", "-", "-", "-", "-", "T", "#", "-", "#", "*", "*", "*", "*", "*"],
    ["*", "*", "*", "*", "*", "#", "#", "#", "#", "#", "#", "#", "#", "#", "#", "#", "#", "#", "#", "#", "#", "#", "#", "#", "#", "*", "*", "*", "*", "*"],
    ["*", "*", "*", "*", "*", "*", "*", "*", "*", "*", "*", "*", "*", "*", "*", "*", "*", "*", "*", "*", "*", "*", "*", "*", "*", "*", "*", "*", "*", "*"],
    ["*", "*", "*", "*", "*", "*", "*", "*", "*", "*", "*", "*", "*", "*", "*", "*", "*", "*", "*", "*", "*", "*", "*", "*", "*", "*", "*", "*", "*", "*"],
    ["*", "*", "*", "*", "*", "*", "*", "*", "*", "*", "*", "*", "*", "*", "*", "*", "*", "*", "*", "*", "*", "*", "*", "*", "*", "*", "*", "*", "*", "*"],
    ["*", "*", "*", "*", "*", "*", "*", "*", "*", "*", "*", "*", "*", "*", "*", "*", "*", "*", "*", "*", "*", "*", "*", "*", "*", "*", "*", "*", "*", "*"],
    ["*", "*", "*", "*", "*", "*", "*", "*", "*", "*", "*", "*", "*", "*", "*", "*", "*", "*", "*", "*", "*", "*", "*", "*", "*", "*", "*", "*", "*", "*"]
  ]
}